##################################################################
##################################################################
###################...............################################
###################...............##............................##
###################...............##............................##
###################...............##....###.....................##
#############################.....##....###.....................##
#############################.....##....###.....................##
###...............................##....###.....................##
###...............................##....###.....................##
###...............................##....###.....................##
###...##############################....##########################
###...##############################....##########################
###...##############################....##########################
###...##############################....##########################
###...##############################....##########################
###.....................................##########################
##################################################################
##################################################################