##################################################################
##################################################################
###################               ################################
###################               ##                            ##
###################               ##                            ##
###################               ##    ###                     ##
#############################     ##    ###                     ##
#############################     ##    ###                     ##
###                               ##    ###                     ##
###                               ##    ###                     ##
###                               ##    ###                     ##
###   ##############################    ##########################
###   ##############################    ##########################
###   ##############################    ##########################
###   ##############################    ##########################
###   ##############################    ##########################
###                                     ##########################
##################################################################
##################################################################